#####################
#A    #         #   #
##### # ####### # # #
#   # #   #   # # # #
# # # # # # ### # ###
# #   # # #   # #   #
# ##### # ### # # # #
#   #   #   # # # # #
### ####### # # ### #
# # #       #   #   #
# # # ####### ### # #
# # # #   # # #   # #
# # # # # # # # ### #
# #   # #   #   #   #
# ##### ######### ###
#                  B#
#####################