#########################
#A#   #   #         #   #
# # # # # # ##### # ### #
#   # # # #     # #   # #
##### # ####### # ### # #
#     # #     # # # #   #
# ##### # # ### # # ### #
#     #   #     # #   # #
##### ### ####### # # # #
#   #   #   #   # # # # #
# ##### ### # # # # ### #
#     #   # # #   #   # #
##### ### ### ##### # # #
#       #   #     # # # #
# ######### # ### # # # #
#   #       # #   # #   #
# # # ######### ### #####
# #             #      B#
#########################