#####################
#A#     #   #       #
# # ### ### # ##### #
# #   #   #       # #
# ### ### # ##### # #
# #   #   # #   # # #
# # ### ### # # ### #
# # #     # # # #   #
# # ##### # # # # # #
# #     # # # #   # #
# # ### # # # ##### #
# # #   # # # #   # #
# ### ### ### # # # #
#     #       # #  B#
#####################