###############
#A#         # #
# # ##### # # #
# # #     #   #
# # # ####### #
# # #     # # #
# ####### # # #
#         #  B#
###############