#######################
#A  # #         #     #
### # # ##### # # # # #
# # #   #   # #   # # #
# # ##### # # ##### # #
# #       # #     # # #
# ######### ### ### # #
#     #   # #   #   # #
### # # # # ### # ### #
#   #   # #   # # # # #
# # ######### ### # # #
# # #       #     # # #
# ### ##### ####### # #
#         #          B#
#######################