##########
#A   #   #
# ## # # #
#    #  B#
##########