###############################
#A  #   #             #       #
### # ### ######### # # ##### #
#   #       #       # # #     #
# ########### ### ##### # ### #
#         #   #   #     #   # #
######### # ####### ####### # #
#     #   #     #       #   # #
##### # ### ### # ####### ### #
#     #   #   #   # #     # # #
# ####### ### ##### # ##### # #
# #       #         # #     # #
# # ####### ######### # # ### #
# # #         #     # # #     #
# # # ######### ### # ##### ###
# # # #     #   #   #     #   #
# # # # ##### ##### ##### ### #
# # #   #   # #   #     #   # #
# # ##### # # # # ##### ### # #
# #       # #   #   # #   # # #
# ######### ####### # ### # # #
#                   #       #B#
###############################