###################
#A    #       #   #
##### # ### # # # #
# #   # #   # # # #
# # ##### ### # # #
# #       #   # # #
# ######### ### ###
#         #   #   #
# ### ####### ### #
# #   #     #   # #
# ##### ### ### # #
#         #      B#
###################