#############################
#A#       #             #   #
# ####### # ### ### ##### # #
#   #   # #   # #   #   # # #
### # # # ### # # ### # # # #
#   # # #     # # #   #   # #
# ### # ####### ### ##### # #
#   # #       # #   #   # # #
### # ####### # # ### # ### #
# #   #   #   # #   # #     #
# ##### ### ### ### # ##### #
#   #     # #   #   #   # # #
# ### ### # # ### ##### # # #
#     # #   #     #     # # #
# ##### ########### ##### # #
#               #   #   #   #
############### # ### ### ###
#   #   #       #   # #   # #
# # # # # ######### # # ### #
# #   #             #      B#
#############################