###########
#A#   #   #
# # # # # #
# # # # # #
# # # # # #
#   #   # #
######### #
#        B#
###########