###########################
#A          #             #
########### # # ######### #
#         # # # #   #   # #
### ### ### # ### # # # # #
#   #   #   # #   #   # # #
# ####### ### # ####### ###
# #     #   #   #   # #   #
# # ### ### ### # # # ### #
#   #     #   # # # # #   #
##### ### ### # # # # # # #
#   #   # #   # # #   # # #
# # ### ### ### # ### # ###
# #     #   # # #   # #   #
# ### ### ### # ### ##### #
#   # #   #         #     #
### # # ############# ### #
#   # #   #   #   #   # # #
# ####### # # # # # ### # #
#           #   #   #    B#
###########################