#############
#A  # #     #
### # # # ###
# # #   #   #
# # ### ### #
# #   #   # #
# ### ##### #
#     #   # #
# ##### # # #
#       #  B#
#############