#################
#A  #   #       #
### # ### ##### #
# # #     #     #
# # ##### # ### #
# #     # # #   #
# ##### # # ### #
#     # # #   # #
# ##### ##### # #
#             #B#
#################